F 0,0,0

NO ./textures/1.xpm
EA ./textures/2.xpm
WE ./textures/3.xpm
SO ./textures/4.xpm

C 2,25,55


11111111111111111111111111111
10000000000000000000000000001
10000000000000000000000000001
10000000000000000000000000001
10000000000000001000000000001
10000000000000010100000000001
10000000000000001000000000001
10000000000000000000000000001
1000000000000000000000000001
1000000000001E0100000000001
1000000000000000000000000001
10000000000000000000000000001
10000000000000000000000000001
10110000011100000010000010001
10010000000000100000000010001
10110000011100000100000010011
10000000001100000111011110001
11110111111111011100000011001
11110111111111011101010010001
11000000110101011100000010001
10001000110100001100000010001
10000000000000001101010010001
10000000000000001101010010001
11000000110101011111011110001
11110111111101011111011110001
11111111111111111111111111111
10010000000000011000000100001
10000000000000001101010010001
11111111111111111111111111111